11111111111111111111111111111111111
100000000000000000000000000000000E1
1C111111111111111111111111111111111
10000000000000000000000000000000001
111111111111111111111111111111111C1
10000000000000000000000000000000001
1C111111111111111111111111111111111
100000000000000000000000000000000P1
11111111111111111111111111111111111
