111111111111111111111111111111111111111111111
100000000000000000000000000000000000000000001
100000000000000000000000000000000000000000001
100111100111011110011001001011100011000000001
100100101000010000100001001010010100100000001
10011110011001110010110100101110011110PCCE001
100100000001010000100101001010100100100000001
100100001110011110011000110010010100100000001
100BBBBBBBBBBBBBBBBBBBBBBBBBBBBBBBBBB00000001
100000000000000000000000000000000000000000001
100000000000000000000000000000000000000000001
111111111111111111111111111111111111111111111
