11111111111111111111111111111111111111111111111111111111111111111111111111111111111111111111111111111111
1E0000000000000C00000C000B000000000C00000C000B000000000C00000C000B000000000C00000C000B0000000CC000000001
111001010010000010100100000001010000101001000000010100001010010000000101000010100100000001010CC000000001
101001001110101000100100000001010010001001000000010100100010010000000101001000100100000001010CC000000001
100000000C00C000B000000000000000C000B000000000000000C000B000000000000000C000B000000000000000CCC000000001
1B0000000000000C00000C000B000000000C00000C000B000000000C00000C000B000000000C00000C000B0000000CC000000001
111001010010000010100100000001010000101001000000010100001010010000000101000010100100000001010CC0000B0001
101001001110101000100100B0000101001000100100B0000101001000100100B0000101001000100100B00001010CC000000001
100000000C00C000B000000000000000C000B000000000000000C000B000000000000000C000B000000000000000CCC000000001
1B0000000000000C00000C000B000000000C00000C000B000000000C00000C000B000000000C00000C000B0000000CC000000001
111001010010000010100100000001010000101001000000010100001010010000000101000010100100000001010CC00B000001
101001001110101000100100000001010010001001000000010100100010010000000101001000100100000001010CC000000001
1B0000000C00C000B00000B000000000C000B00000B000000000C000B00000B000000000C000B00000B000000000CCC000B00001
1B0000000000000C00000C000B000000000C00000C000B000000000C00000C000B000000000C00000C000B0000000CC000000001
111001010010000010100100000001010000101001000000010100001010010000000101000010100100000001010CC000000001
101001001110101000100100000001010010001001000000010100100010010000000101001000100100000001010CC0000B0001
1B0000000000000C00000C000B000000000C00000C000B000000000C00000C000B000000000C00000C000B0000000CC000000001
111001010010000010100100000001010000101001000000010100001010010000000101000010100100000001010CC0000B0001
101001001110101000100100B0000101001000100100B0000101001000100100B0000101001000100100B00001010CC000000001
100000000C00C000B000000000000000C000B000000000000000C000B000000000000000C000B000000000000000CCC000000001
1B0000000000000C00000C000B000000000C00000C000B000000000C00000C000B000000000C00000C000B0000000CC000000001
111001010010000010100100000001010000101001000000010100001010010000000101000010100100000001010CC00B000001
101001001110101000100100000001010010001001000000010100100010010000000101001000100100000001010CC000000001
1B0000000C00C000B00000B000000000C000B00000B000000000C000B00000B000000000C000B00000B000000000CCC000B00001
1B0000000000000C00000C000B000000000C00000C000B000000000C00000C000B000000000C00000C000B0000000CC000000001
100000000C00C000B000000000000000C000B000000000000000C000B000000000000000C000B000000000000000CCC000000P01
11111111111111111111111111111111111111111111111111111111111111111111111111111111111111111111111111111111
