111111111111111111111111111111111111111111111111111
1E0000000000000C00000C00000000000000000000000000001
101001010010000010100100000000000000000000000000001
101001001010101000100100000000000000000000000000001
100000000C00C000000000000000C00CCCC0000000000000001
1E0000000000000C00000C00000CC00000C0000000000000001
10100101001000P01010010000C0C00000C0000000000000001
1010010010101010001001000CCCC00CCCC0000000000000001
100000000C00C000000000000000C00C0000000000000000001
1E0000000000000C00000C000000C00C0000000000000000001
1010010100100000101001000000C00CCCC0000000000000001
101001001010101000100100000000000000000000000000001
100000000C00C00000000000000000000000000000000000001
1E0000000000000C00000C00000000000000000000000000001
10100101001000P010100100000000000000000000000000001
101001001010101000100100000000000000000000000000001
100000000C00C00000000000000000000000000000000000001
1E0000000000000C00000C00000000000000000000000000001
101001010010000010100100000000000000000000000000001
101001001010101000100100000000000000000000000000001
100000000C00C00000000000000000000000000000000000001
1E0000000000000C00000C00000000000000000000000000001
10100101001000P010100100000000000000000000000000001
101001001010101000100100000000000000000000000000001
100000000C00C00000000000000000000000000000000000001
111111111111111111111111111111111111111111111111111